1111111
1000101
11x0001
1101001
1y01001
1111111